111111111111111111111111111111111
10R0000000000C000000C000000000001
100111010011000111001001001111001
1001010100100001C1001001001001001
1000010100100P0000001111001001001
100001010010000000001001001C01001
100001110011000000001001001001001
1000000R00000000000000000000000E1
111111111111111111111111111111111